Level [1,1,0] 
0;1;0;1;1;0 
Level [2,1,121444] 
0;3;3,3;0;3;0 
Level [3,1,312234] 
0;0;1,1,2;2,2,1;0;0 
Level [4,1,112121] 
0;0;5,5,6,5,5;6,6,5,6,6;0;0 
Level [5,1,231122] 
2;2;3,2;3;0;3 
Level [6,1,241234] 
1;1;4;1;4;4 
Level [7,1,223142] 
0;0;0;3,1,1,3,1,1;3;0 
Level [8,1,434312] 
0;4;4;1;4,1,1;0 
Level [9,1,334433] 
0;0;2,2,3;2,3;3;0 
Level [10,3,244321] 
0;0;6,1,6,1,6;1,6,1,6,1;0;0 
Level [11,1,433234] 
0;0;1,6,1,1,6;6;6;0 
Level [12,1,213221] 
0;5,2,5;2,5;2;0;0 
Level [13,1,144343] 
0;4;4,3;3,3;4;0 
Level [14,2,244132] 
0;0;1,1;2,2;1;2 
Level [15,3,441112] 
3;5;3;5;3;5 
Level [16,1,113134] 
1,6,2,3,5,4,1,6,2,3;1,6,2,3,5,4,1,6,2,3;5,1,6,2,3,5,4,1,6,2,3;5,5;0;0 
Level [17,2,434334] 
0;5;2,2;2,5,5;0;0 
Level [18,2,431344] 
0;0;4,1,1,4,4;1,4;0;0 
Level [19,2,331112] 
0;0;6,6,2;2,6,2;0;0 
Level [20,2,411344] 
0;1,3,1;3,1,3;1;1;0 
Level [21,2,241423] 
0;6,6;1,6,1,1,6;0;6;0 
Level [22,2,112341] 
0;0;3,3,2,2,3;2,2;3,2;0 
Level [23,2,132341] 
3;0;3,6,3;6,3,6;0;6 
Level [24,2,411422] 
0;1;6,5,6,6,5,1;1,1,5;0;0
Level [25,3,323212] 
0;4;6,4;6,4,5,6;5,5,4;4 
Level [26,2,311141] 
0;0;6;6,1,6,2,3,5,6,4,1,6;1,6,2,3,5,4,1,6;1,6,2,3,5,4,1,6 
Level [27,2,233124] 
0;0;4,4;1,1,4,1,1,4,1;4;4 
Level [28,3,331243] 
0;1,2;2,1;1;2;0 
Level [29,2,342313] 
0;5;4,4,3,5;5,5,3,4,3,3;0;0 
Level [30,2,144132] 
0;5,2;5,2,2;4,5,4,4;0;0 
Level [31,2,244411] 
0;1,6,5;5,6,1,1,6,1;1,5,1;0;0 
Level [32,2,124334] 
0;5;4,6,5,6;4,5,4,6;0;0 
Level [33,3,242133] 
0;0;5,2,2,5,5,6;6,2;6,6;0 
Level [34,2,413444] 
0;0;2,2,1;1,3,1;2,3;3 
Level [35,3,242133] 
3;3;2,4,3,2,3;4,2,2,4,4,3;0;0 
Level [36,1,442123] 
2,3,3,5,4,4,6,4,2;2,3,3,1,2,1,6,1,5;5,4,2,5,2,3,4,6,3;5,1,1,5,1;2,4,2,2,5;0 
Level [37,2,412412] 
2,6;6,6;2,3,6,6,2;2;3;3 
Level [38,3,143331] 
0;0;5,1,6,6;1,1,5;5,6;0 
Level [39,3,432433] 
0;3;2,6,3,1,6,1;2,2,3,6,1;0;0 
Level [40,3,114134] 
0;3,2;6,2,1;6,6,2,1;3,6,3,6,1,6,6;0 
Level [41,2,132242] 
0;4;4;2,2,1,2,1,1,2,2,4;4;4 
Level [42,3,122114] 
0;5;5,1,1;2,5,2,4;2,1,4,4;0 
Level [43,3,243141] 
0;0;4,3,5,5,6,4;3,5,3,6,4;6;6 
Level [44,3,424222] 
0;0;6,4,6,1,1;4,3,4,6,1;4,3,4,4,3;0 
Level [45,5,113313] 
4,3,4,4,5;5,1,1,2,5;2,3,2,1,3;2,3,2,6,3;5,6,6,2,5;4,3,4,4,5 
Level [46,3,424321] 
6,4,6,4,6,5;5;1,2,2,1,1,5;5;6,2,6,4,6,5;0 
Level [47,3,341414] 
0;1,2,1;2,1;5,2,5,2,5;2;0 
Level [48,3,312134] 
0;2,6;5,5,1,1,2;1,2,6,5,2,6;0;0 
Level [49,3,232333] 
0;6,3,6,4;3,5,6,3,4,5;5,4;0;0 
Level [50,3,222112] 
6,3;4,3;4,6,6;6,3,3;4,3,6;3,6 
Level [51,3,314221] 
0;2,2,5,3,3;5,3,1,5,2;2,1;2,1;0 
Level [52,3,142332] 
4,5,5,4,5,1;4,1,2,5,1,5,2;3,1,3,4,5,4,4;4,4,2;0;0 
Level [53,4,323234] 
0;2,6;6,2,2,6;5,5,1,5,5;6,1,5,1,1,5;0 
Level [54,4,112312] 
0;3,1,3,1,1,6,4;4,1,3,6,4,6;6,6;6;0 
Level [55,4,141441] 
0;1,3,2,1,1,3;3,4,2,1,2,4;3;4;0 
Level [56,3,232424] 
0;3,4,3,3,5;5,4,6;5,3,4,5;6,5,3,6,6,5,3;0 
Level [57,4,311424] 
0;1,6,1,4,6;4,6,1,6;1,4;1;0 
Level [58,4,131431] 
0;1,3,1,2;3,1,1,2;34,2,5,1;5;1 
Level [59,4,441314] 
0;4,4,6,5,6,4;3,3,4,4,5,5,3,4,2;4,4,2,2,6;0;0 
Level [60,4,131441] 
0;2,3;1,3,1,1,2,5;2,1,3,6,3,6,5;3,5,1,3,6;0